11111111111
1000C000001
1C101010001
1110000C001
1C001C10001
11PE100C001
11111111111